######
#E.#G#
#.##.#
#.##.#
#....#
######